1110101100001010010000011011010010000111000000110110110001010000
1110101100001010010000011011010010000111000010100110110001010000
1110101100001010010001001011010010000111000000110110110001010000
1110101100001010010001001011010010000111000010100110110001010000
1110101100001010010000011011010010000111000001100110110001010000
1110101100001010010000011011010010000111000011110110110001010000
1110101100001010010001001011010010000111000001100110110001010000
1110101100001010010001001011010010000111000011110110110001010000
1110101100001010010000011011010010000111000000110110111101010000
1110101100001010010000011011010010000111000010100110111101010000
1110101100001010010001001011010010000111000000110110111101010000
1110101100001010010001001011010010000111000010100110111101010000
1110101100001010010000011011010010000111000001100110111101010000
1110101100001010010000011011010010000111000011110110111101010000
1110101100001010010001001011010010000111000001100110111101010000
1110101100001010010001001011010010000111000011110110111101010000
1110101100001010010000011011010010000111000000110111110101010000
1110101100001010010000011011010010000111000010100111110101010000
1110101100001010010001001011010010000111000000110111110101010000
1110101100001010010001001011010010000111000010100111110101010000
1110101100001010010000011011010010000111000001100111110101010000
1110101100001010010000011011010010000111000011110111110101010000
1110101100001010010001001011010010000111000001100111110101010000
1110101100001010010001001011010010000111000011110111110101010000
1110101100001010010000011011010010000111000000110111111001010000
1110101100001010010000011011010010000111000010100111111001010000
1110101100001010010001001011010010000111000000110111111001010000
1110101100001010010001001011010010000111000010100111111001010000
1110101100001010010000011011010010000111000001100111111001010000
1110101100001010010000011011010010000111000011110111111001010000
1110101100001010010001001011010010000111000001100111111001010000
1110101100001010010001001011010010000111000011110111111001010000
1110101100001010011000001011010010000111000000110110110001010000
1110101100001010011000001011010010000111000010100110110001010000
1110101100001010011001011011010010000111000000110110110001010000
1110101100001010011001011011010010000111000010100110110001010000
1110101100001010011000001011010010000111000001100110110001010000
1110101100001010011000001011010010000111000011110110110001010000
1110101100001010011001011011010010000111000001100110110001010000
1110101100001010011001011011010010000111000011110110110001010000
1110101100001010011000001011010010000111000000110110111101010000
1110101100001010011000001011010010000111000010100110111101010000
1110101100001010011001011011010010000111000000110110111101010000
1110101100001010011001011011010010000111000010100110111101010000
1110101100001010011000001011010010000111000001100110111101010000
1110101100001010011000001011010010000111000011110110111101010000
1110101100001010011001011011010010000111000001100110111101010000
1110101100001010011001011011010010000111000011110110111101010000
1110101100001010011000001011010010000111000000110111110101010000
1110101100001010011000001011010010000111000010100111110101010000
1110101100001010011001011011010010000111000000110111110101010000
1110101100001010011001011011010010000111000010100111110101010000
1110101100001010011000001011010010000111000001100111110101010000
1110101100001010011000001011010010000111000011110111110101010000
1110101100001010011001011011010010000111000001100111110101010000
1110101100001010011001011011010010000111000011110111110101010000
1110101100001010011000001011010010000111000000110111111001010000
1110101100001010011000001011010010000111000010100111111001010000
1110101100001010011001011011010010000111000000110111111001010000
1110101100001010011001011011010010000111000010100111111001010000
1110101100001010011000001011010010000111000001100111111001010000
1110101100001010011000001011010010000111000011110111111001010000
1110101100001010011001011011010010000111000001100111111001010000
1110101100001010011001011011010010000111000011110111111001010000
1110101100001010010000011111010110000111000000110110110001010000
1110101100001010010000011111010110000111000010100110110001010000
1110101100001010010001001111010110000111000000110110110001010000
1110101100001010010001001111010110000111000010100110110001010000
1110101100001010010000011111010110000111000001100110110001010000
1110101100001010010000011111010110000111000011110110110001010000
1110101100001010010001001111010110000111000001100110110001010000
1110101100001010010001001111010110000111000011110110110001010000
1110101100001010010000011111010110000111000000110110111101010000
1110101100001010010000011111010110000111000010100110111101010000
1110101100001010010001001111010110000111000000110110111101010000
1110101100001010010001001111010110000111000010100110111101010000
1110101100001010010000011111010110000111000001100110111101010000
1110101100001010010000011111010110000111000011110110111101010000
1110101100001010010001001111010110000111000001100110111101010000
1110101100001010010001001111010110000111000011110110111101010000
1110101100001010010000011111010110000111000000110111110101010000
1110101100001010010000011111010110000111000010100111110101010000
1110101100001010010001001111010110000111000000110111110101010000
1110101100001010010001001111010110000111000010100111110101010000
1110101100001010010000011111010110000111000001100111110101010000
1110101100001010010000011111010110000111000011110111110101010000
1110101100001010010001001111010110000111000001100111110101010000
1110101100001010010001001111010110000111000011110111110101010000
1110101100001010010000011111010110000111000000110111111001010000
1110101100001010010000011111010110000111000010100111111001010000
1110101100001010010001001111010110000111000000110111111001010000
1110101100001010010001001111010110000111000010100111111001010000
1110101100001010010000011111010110000111000001100111111001010000
1110101100001010010000011111010110000111000011110111111001010000
1110101100001010010001001111010110000111000001100111111001010000
1110101100001010010001001111010110000111000011110111111001010000
1110101100001010011000001111010110000111000000110110110001010000
1110101100001010011000001111010110000111000010100110110001010000
1110101100001010011001011111010110000111000000110110110001010000
1110101100001010011001011111010110000111000010100110110001010000
1110101100001010011000001111010110000111000001100110110001010000
1110101100001010011000001111010110000111000011110110110001010000
1110101100001010011001011111010110000111000001100110110001010000
1110101100001010011001011111010110000111000011110110110001010000
1110101100001010011000001111010110000111000000110110111101010000
1110101100001010011000001111010110000111000010100110111101010000
1110101100001010011001011111010110000111000000110110111101010000
1110101100001010011001011111010110000111000010100110111101010000
1110101100001010011000001111010110000111000001100110111101010000
1110101100001010011000001111010110000111000011110110111101010000
1110101100001010011001011111010110000111000001100110111101010000
1110101100001010011001011111010110000111000011110110111101010000
1110101100001010011000001111010110000111000000110111110101010000
1110101100001010011000001111010110000111000010100111110101010000
1110101100001010011001011111010110000111000000110111110101010000
1110101100001010011001011111010110000111000010100111110101010000
1110101100001010011000001111010110000111000001100111110101010000
1110101100001010011000001111010110000111000011110111110101010000
1110101100001010011001011111010110000111000001100111110101010000
1110101100001010011001011111010110000111000011110111110101010000
1110101100001010011000001111010110000111000000110111111001010000
1110101100001010011000001111010110000111000010100111111001010000
1110101100001010011001011111010110000111000000110111111001010000
1110101100001010011001011111010110000111000010100111111001010000
1110101100001010011000001111010110000111000001100111111001010000
1110101100001010011000001111010110000111000011110111111001010000
1110101100001010011001011111010110000111000001100111111001010000
1110101100001010011001011111010110000111000011110111111001010000
1110101100001010010000011011010010000111000000110110110011010001
1110101100001010010000011011010010000111000010100110110011010001
1110101100001010010001001011010010000111000000110110110011010001
1110101100001010010001001011010010000111000010100110110011010001
1110101100001010010000011011010010000111000001100110110011010001
1110101100001010010000011011010010000111000011110110110011010001
1110101100001010010001001011010010000111000001100110110011010001
1110101100001010010001001011010010000111000011110110110011010001
1110101100001010010000011011010010000111000000110110111111010001
1110101100001010010000011011010010000111000010100110111111010001
1110101100001010010001001011010010000111000000110110111111010001
1110101100001010010001001011010010000111000010100110111111010001
1110101100001010010000011011010010000111000001100110111111010001
1110101100001010010000011011010010000111000011110110111111010001
1110101100001010010001001011010010000111000001100110111111010001
1110101100001010010001001011010010000111000011110110111111010001
1110101100001010010000011011010010000111000000110111110111010001
1110101100001010010000011011010010000111000010100111110111010001
1110101100001010010001001011010010000111000000110111110111010001
1110101100001010010001001011010010000111000010100111110111010001
1110101100001010010000011011010010000111000001100111110111010001
1110101100001010010000011011010010000111000011110111110111010001
1110101100001010010001001011010010000111000001100111110111010001
1110101100001010010001001011010010000111000011110111110111010001
1110101100001010010000011011010010000111000000110111111011010001
1110101100001010010000011011010010000111000010100111111011010001
1110101100001010010001001011010010000111000000110111111011010001
1110101100001010010001001011010010000111000010100111111011010001
1110101100001010010000011011010010000111000001100111111011010001
1110101100001010010000011011010010000111000011110111111011010001
1110101100001010010001001011010010000111000001100111111011010001
1110101100001010010001001011010010000111000011110111111011010001
1110101100001010011000001011010010000111000000110110110011010001
1110101100001010011000001011010010000111000010100110110011010001
1110101100001010011001011011010010000111000000110110110011010001
1110101100001010011001011011010010000111000010100110110011010001
1110101100001010011000001011010010000111000001100110110011010001
1110101100001010011000001011010010000111000011110110110011010001
1110101100001010011001011011010010000111000001100110110011010001
1110101100001010011001011011010010000111000011110110110011010001
1110101100001010011000001011010010000111000000110110111111010001
1110101100001010011000001011010010000111000010100110111111010001
1110101100001010011001011011010010000111000000110110111111010001
1110101100001010011001011011010010000111000010100110111111010001
1110101100001010011000001011010010000111000001100110111111010001
1110101100001010011000001011010010000111000011110110111111010001
1110101100001010011001011011010010000111000001100110111111010001
1110101100001010011001011011010010000111000011110110111111010001
1110101100001010011000001011010010000111000000110111110111010001
1110101100001010011000001011010010000111000010100111110111010001
1110101100001010011001011011010010000111000000110111110111010001
1110101100001010011001011011010010000111000010100111110111010001
1110101100001010011000001011010010000111000001100111110111010001
1110101100001010011000001011010010000111000011110111110111010001
1110101100001010011001011011010010000111000001100111110111010001
1110101100001010011001011011010010000111000011110111110111010001
1110101100001010011000001011010010000111000000110111111011010001
1110101100001010011000001011010010000111000010100111111011010001
1110101100001010011001011011010010000111000000110111111011010001
1110101100001010011001011011010010000111000010100111111011010001
1110101100001010011000001011010010000111000001100111111011010001
1110101100001010011000001011010010000111000011110111111011010001
1110101100001010011001011011010010000111000001100111111011010001
1110101100001010011001011011010010000111000011110111111011010001
1110101100001010010000011111010110000111000000110110110011010001
1110101100001010010000011111010110000111000010100110110011010001
1110101100001010010001001111010110000111000000110110110011010001
1110101100001010010001001111010110000111000010100110110011010001
1110101100001010010000011111010110000111000001100110110011010001
1110101100001010010000011111010110000111000011110110110011010001
1110101100001010010001001111010110000111000001100110110011010001
1110101100001010010001001111010110000111000011110110110011010001
1110101100001010010000011111010110000111000000110110111111010001
1110101100001010010000011111010110000111000010100110111111010001
1110101100001010010001001111010110000111000000110110111111010001
1110101100001010010001001111010110000111000010100110111111010001
1110101100001010010000011111010110000111000001100110111111010001
1110101100001010010000011111010110000111000011110110111111010001
1110101100001010010001001111010110000111000001100110111111010001
1110101100001010010001001111010110000111000011110110111111010001
1110101100001010010000011111010110000111000000110111110111010001
1110101100001010010000011111010110000111000010100111110111010001
1110101100001010010001001111010110000111000000110111110111010001
1110101100001010010001001111010110000111000010100111110111010001
1110101100001010010000011111010110000111000001100111110111010001
1110101100001010010000011111010110000111000011110111110111010001
1110101100001010010001001111010110000111000001100111110111010001
1110101100001010010001001111010110000111000011110111110111010001
1110101100001010010000011111010110000111000000110111111011010001
1110101100001010010000011111010110000111000010100111111011010001
1110101100001010010001001111010110000111000000110111111011010001
1110101100001010010001001111010110000111000010100111111011010001
1110101100001010010000011111010110000111000001100111111011010001
1110101100001010010000011111010110000111000011110111111011010001
1110101100001010010001001111010110000111000001100111111011010001
1110101100001010010001001111010110000111000011110111111011010001
1110101100001010011000001111010110000111000000110110110011010001
1110101100001010011000001111010110000111000010100110110011010001
1110101100001010011001011111010110000111000000110110110011010001
1110101100001010011001011111010110000111000010100110110011010001
1110101100001010011000001111010110000111000001100110110011010001
1110101100001010011000001111010110000111000011110110110011010001
1110101100001010011001011111010110000111000001100110110011010001
1110101100001010011001011111010110000111000011110110110011010001
1110101100001010011000001111010110000111000000110110111111010001
1110101100001010011000001111010110000111000010100110111111010001
1110101100001010011001011111010110000111000000110110111111010001
1110101100001010011001011111010110000111000010100110111111010001
1110101100001010011000001111010110000111000001100110111111010001
1110101100001010011000001111010110000111000011110110111111010001
1110101100001010011001011111010110000111000001100110111111010001
1110101100001010011001011111010110000111000011110110111111010001
1110101100001010011000001111010110000111000000110111110111010001
1110101100001010011000001111010110000111000010100111110111010001
1110101100001010011001011111010110000111000000110111110111010001
1110101100001010011001011111010110000111000010100111110111010001
1110101100001010011000001111010110000111000001100111110111010001
1110101100001010011000001111010110000111000011110111110111010001
1110101100001010011001011111010110000111000001100111110111010001
1110101100001010011001011111010110000111000011110111110111010001
1110101100001010011000001111010110000111000000110111111011010001
1110101100001010011000001111010110000111000010100111111011010001
1110101100001010011001011111010110000111000000110111111011010001
1110101100001010011001011111010110000111000010100111111011010001
1110101100001010011000001111010110000111000001100111111011010001
1110101100001010011000001111010110000111000011110111111011010001
1110101100001010011001011111010110000111000001100111111011010001
1110101100001010011001011111010110000111000011110111111011010001
